0,01,02,02,01,0,01,0,0,10
0,0,02,02,01,0,0,02,02,01
0,0,02,02,01,01,0,02,02,01
0,0,02,02,01,0,01,0,0,01
01,0,02,02,01,0,01,02,01,01
01,0,02,01,01,0,01,02,02,0
01,01,01,01,01,01,01,01,01,0
01,01,01,01,0,0,0,0,0,0
01,01,0,01,0,02,02,02,02,0
01,01,0,01,0,02,02,02,02,02
01,01,0,01,0,02,02,02,02,02
01,01,0,01,0,02,02,02,02,0
0,0,02,02,01,0,01,0,0,01
01,01,0,01,0,02,02,02,02,0
01,01,0,01,0,02,02,02,02,0
01,01,0,01,0,02,02,02,02,0
01,01,01,01,0,0,0,0,0,0
01,0,02,02,01,0,01,02,01,01
01,01,0,01,0,02,02,02,02,0
01,01,0,01,0,02,02,02,02,0