00,00,00,00,00,00,00,00,00,05,02,02,02,02,02,02,02,02,02,02,02,02,02,02,02
00,00,00,00,00,00,00,05,05,02,02,02,02,02,02,02,02,02,02,02,02,02,02,02,02
00,00,00,00,00,00,05,05,02,02,02,02,02,02,02,02,02,02,02,02,02,02,02,02,02
00,00,00,00,00,05,05,02,02,02,02,03,03,03,03,03,03,03,03,03,03,03,03,03,03
00,00,00,00,00,05,02,02,03,03,03,00,00,00,00,00,00,00,00,00,00,00,01,01,01
00,00,00,00,00,00,00,02,03,00,00,00,00,00,00,00,01,01,01,01,01,02,02,02,02
00,00,00,00,00,00,00,00,03,00,00,00,00,00,00,01,01,01,01,01,02,02,02,02,02
00,00,00,00,00,00,00,00,00,00,00,00,00,00,01,02,02,02,02,02,02,02,02,02,02
00,00,00,00,00,00,00,00,00,00,01,01,01,01,01,02,02,02,02,02,02,02,02,02,02
00,00,00,00,00,00,00,00,01,01,01,01,01,01,02,02,02,02,02,02,02,02,02,02,02
00,00,00,00,00,00,00,01,01,01,01,01,01,02,02,02,02,02,02,02,02,02,02,02,02
00,00,00,00,00,01,01,01,01,01,01,01,02,02,02,02,02,02,02,02,02,02,02,02,02
00,00,00,00,01,01,01,01,01,01,01,02,02,02,02,02,02,02,02,02,01,02,02,02,02
00,00,00,00,01,05,01,01,01,01,02,02,02,02,02,02,02,02,02,02,01,02,02,02,02
00,00,00,00,01,05,01,01,01,01,02,02,02,02,02,02,02,02,02,02,01,02,02,02,02
00,00,00,00,01,01,05,01,01,02,02,02,02,02,02,02,02,02,02,02,01,02,02,02,02
00,00,00,01,01,01,05,01,01,02,02,02,02,02,02,02,02,02,02,02,02,02,02,02,02
00,00,00,01,01,01,01,02,02,02,02,02,02,02,02,02,02,02,02,02,02,02,02,02,02
00,00,01,01,00,01,01,01,02,02,02,02,02,02,02,02,02,02,02,02,02,02,02,02,00
00,00,00,00,00,01,01,02,02,02,02,02,02,02,02,02,02,02,02,02,00,00,00,00,00