00,00,00,00,00,00,00,00,00,05,02,02,02,02,02,02,02,02,02,02,02,02,02,02,02,02,02,02,02,02,02,02
00,00,00,00,00,00,00,05,05,02,02,02,02,02,02,02,02,02,02,05,01,01,04,03,06,02,02,02,02,02,02,02
00,00,00,00,00,00,05,05,02,02,02,02,02,02,02,02,02,02,02,02,02,02,02,02,02,02,02,02,02,02,02,02
00,00,00,00,00,05,05,02,02,02,02,03,03,03,03,03,03,03,03,03,03,03,03,03,03,03,03,00,00,00,00,03
00,00,00,00,00,05,02,02,03,03,03,00,00,00,00,00,00,00,00,00,00,00,01,01,01,01,01,00,00,00,00,00
00,00,00,00,00,00,00,02,03,00,00,00,00,00,00,00,00,00,00,00,00,00,00,00,00,00,02,01,00,00,00,00
00,00,00,00,00,00,00,00,03,00,00,00,00,00,00,00,00,00,00,00,00,00,00,00,00,00,02,01,00,00,00,00
00,00,00,00,00,00,00,00,00,00,00,00,00,00,00,00,00,00,00,00,00,00,00,00,00,00,02,02,00,00,00,00
00,00,00,00,00,00,00,00,00,00,01,01,01,01,00,00,01,01,01,01,01,01,00,00,00,00,02,02,01,00,00,00
00,00,00,00,00,00,00,00,00,00,00,00,00,00,00,00,01,01,01,01,01,01,01,00,00,00,02,02,01,00,00,00
00,00,00,00,00,00,00,00,00,01,01,01,00,00,00,00,00,01,00,01,01,00,00,00,00,02,02,02,01,00,00,00
00,00,00,00,00,01,01,00,01,01,01,01,01,00,00,00,00,00,00,00,00,00,00,00,02,02,02,02,02,02,00,00
00,00,00,00,01,01,00,00,01,01,01,01,01,00,00,02,02,02,02,02,01,02,02,02,02,02,02,02,02,01,00,00
00,00,00,00,01,05,00,00,00,01,01,01,01,00,00,02,02,02,02,02,01,02,02,02,02,02,02,02,02,02,00,00
00,00,00,00,01,05,00,00,00,00,00,00,00,00,02,02,02,02,02,02,01,02,02,02,02,02,02,02,02,02,00,00
00,00,00,00,01,01,00,00,00,00,00,00,00,02,02,02,02,02,02,02,01,02,02,02,02,02,02,02,02,02,00,00
00,00,00,01,01,01,05,00,00,00,00,00,02,02,02,02,02,02,02,02,02,02,02,02,02,02,02,02,02,02,00,00
00,00,00,01,01,01,01,00,00,00,00,02,02,02,02,02,02,02,02,02,02,02,02,02,02,02,02,02,02,02,02,00
00,00,01,01,00,01,01,01,02,02,02,02,02,02,02,02,02,02,02,02,02,02,02,02,00,00,02,02,02,02,02,00
00,00,00,00,00,01,01,02,02,02,02,02,02,02,02,02,02,02,02,02,00,00,00,00,00,00,02,02,02,02,02,00
00,00,00,00,00,00,01,01,02,02,02,02,02,01,02,00,00,00,00,00,00,00,00,00,00,02,02,02,02,01,02,00
00,00,00,00,00,00,02,01,01,02,02,02,02,02,02,00,00,00,00,00,00,00,00,00,02,02,02,02,02,01,02,00
00,00,00,00,00,00,00,02,02,02,02,02,02,02,02,02,00,00,00,00,00,00,02,02,02,02,02,02,01,02,02,00
00,00,00,00,00,00,00,00,02,02,02,02,02,02,02,02,02,02,00,00,00,02,02,02,02,02,02,02,01,02,02,00
00,04,04,00,00,00,00,00,02,02,02,02,02,02,02,02,02,02,02,02,02,02,02,02,02,02,02,01,02,02,02,00
04,04,02,04,04,04,00,00,00,02,01,01,02,02,02,02,02,02,02,02,02,02,02,02,02,02,01,01,02,02,02,00
04,02,02,02,02,04,00,00,00,00,02,01,01,01,01,02,02,02,02,02,02,02,02,02,01,01,02,02,02,02,02,00
02,02,02,02,02,02,02,06,00,00,00,00,00,02,02,02,02,02,02,02,02,02,02,01,02,02,02,02,02,02,02,00
02,02,02,02,02,02,02,02,00,00,00,00,00,00,00,02,02,02,02,02,02,01,01,02,02,02,02,02,02,02,02,00
02,02,02,02,02,02,02,02,06,00,00,00,00,00,00,00,00,00,00,00,00,00,00,00,00,00,00,00,00,00,00,00
02,02,02,02,02,02,02,02,01,01,01,01,01,01,01,01,01,01,01,01,01,01,01,00,00,00,00,00,00,00,00,00
02,02,02,02,02,02,02,06,06,01,01,01,01,01,01,01,01,01,01,01,01,01,01,01,01,01,01,01,01,01,01,00